15 30 431
##############################
# *  *   *     *      *     *#
#      **  * *     ###   **  #
#   *     *      #           #
# * **  *  B   * #  P ##*##  #
#  ##       *  ###   ##  ##* #
# ##  #####* #  *  #  *    * #
# *     #   ##* # *#    ###  #
#*##    #*   # ##  #**  #    #
# ##   >        #       #  * #
#   *    #####    #####   C  #
# ##*##    #   ##   #   ## **#
# ##  ## * # * ##   #   ##   #
# *    *          *          #
##############################
