10 10 20
##########
#   *    #
# ##  ## #
#  ## ## #
#   B   *#
# #   #  #
# ## ##  #
#  # #   #
#     >  #
##########
