30 15 159
###############
#         *   #
#       ###  *#
#      *###   #
# *     ###   #
#       ###   #
#   ***I###>#*#
#       ###*#*#
# #####     # #
#   #    #   P#
#   #   ### # #
#     *    *#*#
#*###### #  # #
# ###### #    #
# ######*###  #
#      B #    #
#*###### #    #
#*######     *#
# ###### #   *#
#  C     ## * #
# * ###   # * #
#*  ### *     #
#   ### ###   #
#   ###* #    #
#   ### *     #
# # ### ### # #
# #         # #
# # ### ### # #
#       *  *  #
###############
