17 19 276
###################
#       * *  %    #
#        * *   *  #
# ### ###  * *    #
#*  % *** ###   # #
#   ##    C *  ## #
#*#  ## ######  # #
#*#***  ###### *  #
# ###*  ######  #*#
# #      *  *   # #
#I# ##    B   #P# #
# %*## *   %  #  %#
# # *  **#  # ### #
# ## ###*## # #   #
# #  *# > # #%#   #
#*       **     * #
###################
