20 14 230
##############
# **         #
#     #####  #
# * %*  #    #
#   # P #    #
#   #      % #
# #####    #*#
#>       *## #
#  #    # #  #
# ###   #*%* #
#     #*###* #
# # * #  C*  #
# # #####*** #
# #I *    ##*#
#      * ##  #
#%######  %  #
# ######*### #
#*######* #  #
#* B* *      #
##############
