10 30 272
##############################
#  *   *               *   * #
# *   *  *   *         **  * #
#  *  #    *   *          #  #
#    *# *          >      #  #
#     ### ######*     * ###C #
#  # *#   ######*## *   * #  #
# ### #I  ###### ## ###   # *#
#   **      * *              #
##############################
