10 10 72
##########
#    *  *#
#*## ### #
# ##  #  #
#   * > *#
# # I # *#
# ##*## P#
#  #  #* #
#        #
##########
