10 15 107
###############
#     C   ** *#
#   *  ### ## #
#*    *### ##*#
#  B   ###    #
# #  * ### # *#
# # ## ###*## #
# # ## ###  #*#
#       >     #
###############
