22 16 312
################
# *            #
# %       *#  %#
#      * **# * #
#    C   ### * #
# ######     P #
# ######   ## *#
# ###### #  ## #
# *    **#     #
#   # * *###   #
# % # *  #     #
# ###  * #     #
#     ##     * #
# ###* ##  #   #
#**  %  B ##   #
# ### ###  #   #
#     * *  %   #
# #   *%### #  #
# ##*##I *# #  #
#  # ##   # #  #
#   >  *  *    #
################
