20 20 332
####################
#  *    * *   *    #
#*      * * ##*   *#
#     *    * ## ## #
#  ## ##* #* *  ## #
# ##   ## #  ##  *I#
#     C   # ##*  # #
# #####* *   B  ## #
#   #   ###*### #  #
#* *#    #  ### *  #
# *      ** ### ## #
# ######    ### ## #
# ###### *# ###    #
#*######*## ### #  #
#  >     # *    #  #
#   #  **   #*###  #
#   #    ##*#    P #
# ##### ##  ###  * #
#     *      *    *#
####################
