15 15 189
###############
#*            #
# ### ###  ##*#
#  *     * ## #
#*  ###  #    #
#  *#   ## ## #
# * #    # ## #
# #  C  *    *#
# ##  >   #  *#
# #    B ###  #
#      #      #
#P###*##*###  #
#  #   #  #   #
#  *   * * *  #
###############
