10 40 338
########################################
#   **        *  >  **   *       * *   #
#  *       *    ### ##  ##  ##  ##  ## #
#   C  # ### ##* #  ## ##  ##  ##  ##**#
#*     #  B  ##    *         *         #
# #* ###* # * * #####  # ### ### ### # #
# ##   # ##*## P *#   ## #   # *I  # # #
#  #   # #   ##   # * #* # * #     # #*#
#*  * *     *      *           *       #
########################################
